111111111111111111111111111111
1E1000000000C001000000000000C1
100C011000000000000000C0000001
100010100111101001111010011001
1001001001001C1001010010100101
100111110001001001100010100101
10000C1C0010C01001C1001C100101
101000100111101001001010011001
1P100000C00000C0000000000000C1
111111111111111111111111111111
