1111111111111111111
1E0000000000000C001
1010010100100000101
1010010010101010001
1P0000000C00C010C01
111000100111101C001
1C100000010C0010C01
1000110000000001111
10000C00001C01000C1
1111111111111111111
